5.ox
o..o......o.
....o......o
....o....o..
.ooo.......3
..o.o.....oo
